111111111111111111111111
100000000000000000000001
100000000100100000000001
100000000000000110010001
100000100000000000010001
100000000000000000000001
10011100000E000000000001
100001000000000000000001
100001000000000000010001
100000000000000000000001
100000000000000000000001
100000000000000000000001
111111111111111111111111
