 11111111     11111
 100000011111111001
11001000000000000011111111
100000001111110000000000011
100000000000000001111000001
100000100000000000000000001
1111000000N0000000111100001
   1000000000000001  111111
   1111111111111111
