111111111111111111111111111111111111111111
100000000000000000000000000000000000000001
100000000100100000000000000000000000000001
100000000000000110010000000000000000000001
100000100000000000010000000000000000000001
100000000000000000000000000000000000000001
100111000000000000000000000000000000000001
100001000000000000000000000000000000000001
100001000000000000010000000000000001000001
100000000000000000000000000000000001000001
100000000000000000000000000000000001000001
100000000000000000000000000000000000000001
100000000000000000000000011100000001000001
100000000000000000000000000000000001000001
100000000000000000000E00000000000000000001
100000010000000000000000000000000000000001
100000000000000000000000000000000000000001
100000000000000000000000000000000000000001
100000010000000000000000000000000000000001
100000000000000000000000000000000000000001
100000000000000000000000000000001000000001
100000000000000000000000000000001000000001
100000000000000000000000000000001000000001
100000000000000000000000001111101000000001
100000000000000000000000000000000000000001
100000000000000000000000000000000000000001
100000000000000000000000000000000000000001
111111111111111111111111111111111111111111
